map.properties.rows:            40
map.properties.columns:         40


map.textures.wall:
3 3 3 3 3 3 3 3 3 3 3 3 3 3 3 3 3 3 3 3 3 3 3 3 3 3 3 3 3 3 3 3 3 3 3 3 3 3 3 3
3 3 3 3 3 3 3 3 3 3 3 3 3 3 3 3 3 3 3 3 3 3 3 3 3 3 3 3 3 3 3 3 3 3 3 3 3 3 3 3
3 3 3 3 3 3 3 3 3 3 3 3 3 3 3 3 3 3 3 3 3 3 3 3 3 3 3 3 3 3 3 3 3 3 3 3 3 3 3 3
3 3 9 9 9 9 9 9 9 9 9 9 9 9 9 9 9 9 9 9 9 9 9 9 9 9 9 9 9 9 9 9 9 9 9 9 9 3 3 3
3 3 9 1 1 1 1 1 1 1 1 1 1 1 1 1 1 1 1 1 1 1 1 1 1 1 1 1 1 1 1 1 1 1 1 1 9 3 3 3
3 3 9 1 1 1 1 1 1 1 1 1 1 1 1 1 1 1 1 1 1 1 1 1 1 1 1 1 1 1 1 1 1 1 1 1 9 3 3 3
3 3 9 1 1 1 1 1 1 1 1 1 1 1 1 1 1 1 1 1 1 1 1 1 1 1 1 1 1 1 1 1 1 1 1 1 9 3 3 3
3 3 9 1 1 1 9 9 9 9 9 9 9 9 9 9 9 9 1 1 1 9 9 9 9 9 9 9 9 9 9 9 9 1 1 1 9 3 3 3
3 3 9 1 1 1 9 3 3 3 3 3 3 3 3 3 3 9 1 1 1 9 3 3 3 3 3 3 3 3 3 3 9 1 1 1 9 3 3 3
3 3 9 1 1 1 9 3 3 3 3 3 3 3 3 3 3 9 1 1 1 9 3 3 3 3 3 3 3 3 3 3 9 1 1 1 9 3 3 3
3 3 9 1 1 1 9 3 3 3 3 3 3 3 3 3 3 9 1 1 1 9 3 3 3 3 3 3 3 3 3 3 9 1 1 1 9 3 3 3
3 3 9 1 1 1 9 3 3 3 2 2 2 2 2 2 2 2 1 1 1 2 2 2 2 2 2 2 2 3 3 3 9 1 1 1 9 3 3 3
3 3 9 1 1 1 9 3 3 3 2 1 1 1 1 1 1 1 1 1 1 1 1 1 1 1 1 1 2 3 3 3 9 1 1 1 9 3 3 3
3 3 9 1 1 1 9 3 3 3 2 1 1 1 1 1 1 1 1 1 1 1 1 1 1 1 1 1 2 3 3 3 9 1 1 1 9 3 3 3
3 3 9 1 1 1 9 3 3 3 2 1 1 6 6 6 6 6 6 6 6 6 6 6 6 6 1 1 2 3 3 3 9 1 1 1 9 3 3 3
3 3 9 1 1 1 9 3 3 3 2 1 1 6 5 5 5 5 5 5 5 5 5 5 5 6 1 1 2 3 3 3 9 1 1 1 9 3 3 3
3 3 9 1 1 1 9 3 3 3 2 1 1 6 5 7 5 5 5 5 5 5 5 7 5 6 1 1 2 3 3 3 9 1 1 1 9 3 3 3
3 3 9 1 1 1 9 3 3 3 2 1 1 6 5 5 5 5 5 5 5 5 5 5 5 6 1 1 2 3 3 3 9 1 1 1 9 3 3 3
3 3 9 1 1 1 9 9 9 9 2 1 1 6 5 5 5 6 6 6 6 6 5 5 5 6 1 1 2 9 9 9 9 1 1 1 9 3 3 3
3 3 9 1 1 1 1 1 1 1 1 1 1 6 5 5 5 6 5 5 5 6 5 5 5 6 1 1 1 1 1 1 1 1 1 1 9 3 3 3
3 3 9 1 1 1 1 1 1 1 1 1 1 6 5 5 5 6 5 7 5 6 5 5 5 6 1 1 1 1 1 1 1 1 1 1 9 3 3 3
3 3 9 1 1 1 1 1 1 1 1 1 1 6 5 5 5 6 5 5 5 6 5 5 5 6 1 1 1 1 1 1 1 1 1 1 9 3 3 3
3 3 9 1 1 1 9 9 9 9 2 1 1 6 5 5 5 6 6 6 6 6 5 5 5 6 1 1 2 9 9 9 9 1 1 1 9 3 3 3
3 3 9 1 1 1 9 3 3 3 2 1 1 6 5 5 5 5 5 5 5 5 5 5 5 6 1 1 2 3 3 3 9 1 1 1 9 3 3 3
3 3 9 1 1 1 9 3 3 3 2 1 1 6 5 7 5 5 5 5 5 5 5 7 5 6 1 1 2 3 3 3 9 1 1 1 9 3 3 3
3 3 9 1 1 1 9 3 3 3 2 1 1 6 5 5 5 5 5 5 5 5 5 5 5 6 1 1 2 3 3 3 9 1 1 1 9 3 3 3
3 3 9 1 1 1 9 3 3 3 2 1 1 6 6 6 6 6 6 6 6 6 6 6 6 6 1 1 2 3 3 3 9 1 1 1 9 3 3 3
3 3 9 1 1 1 9 3 3 3 2 1 1 1 1 1 1 1 1 1 1 1 1 1 1 1 1 1 2 3 3 3 9 1 1 1 9 3 3 3
3 3 9 1 1 1 9 3 3 3 2 1 1 1 1 1 1 1 1 1 1 1 1 1 1 1 1 1 2 3 3 3 9 1 1 1 9 3 3 3
3 3 9 1 1 1 9 3 3 3 2 2 2 2 2 2 2 2 1 1 1 2 2 2 2 2 2 2 2 3 3 3 9 1 1 1 9 3 3 3
3 3 9 1 1 1 9 3 3 3 3 3 3 3 3 3 3 9 1 1 1 9 3 3 3 3 3 3 3 3 3 3 9 1 1 1 9 3 3 3
3 3 9 1 1 1 9 3 3 3 3 3 3 3 3 3 3 9 1 1 1 9 3 3 3 3 3 3 3 3 3 3 9 1 1 1 9 3 3 3
3 3 9 1 1 1 9 3 3 3 3 3 3 3 3 3 3 9 1 1 1 9 3 3 3 3 3 3 3 3 3 3 9 1 1 1 9 3 3 3
3 3 9 1 1 1 9 9 9 9 9 9 9 9 9 9 9 9 1 1 1 9 9 9 9 9 9 9 9 9 9 9 9 1 1 1 9 3 3 3
3 3 9 1 1 1 1 1 1 1 1 1 1 1 1 1 1 1 1 1 1 1 1 1 1 1 1 1 1 1 1 1 1 1 1 1 9 3 3 3
3 3 9 1 1 1 1 1 1 1 1 1 1 1 1 1 1 1 1 1 1 1 1 1 1 1 1 1 1 1 1 1 1 1 1 1 9 3 3 3
3 3 9 1 1 1 1 1 1 1 1 1 1 1 1 1 1 1 1 1 1 1 1 1 1 1 1 1 1 1 1 1 1 1 1 1 9 3 3 3
3 3 9 9 9 9 9 9 9 9 9 9 9 9 9 9 9 9 9 9 9 9 9 9 9 9 9 9 9 9 9 9 9 9 9 9 9 3 3 3
3 3 3 3 3 3 3 3 3 3 3 3 3 3 3 3 3 3 3 3 3 3 3 3 3 3 3 3 3 3 3 3 3 3 3 3 3 3 3 3
3 3 3 3 3 3 3 3 3 3 3 3 3 3 3 3 3 3 3 3 3 3 3 3 3 3 3 3 3 3 3 3 3 3 3 3 3 3 3 3


map.textures.floor:
4 4 4 4 4 4 4 4 4 4 4 4 4 4 4 4 4 4 4 4 4 4 4 4 4 4 4 4 4 4 4 4 4 4 4 4 4 4 4 4
4 4 4 4 4 4 4 4 4 4 4 4 4 4 4 4 4 4 4 4 4 4 4 4 4 4 4 4 4 4 4 4 4 4 4 4 4 4 4 4
4 4 4 4 4 4 4 4 4 4 4 4 4 4 4 4 4 4 4 4 4 4 4 4 4 4 4 4 4 4 4 4 4 4 4 4 4 4 4 4
4 4 9 9 9 9 9 9 9 9 9 9 9 9 9 9 9 9 9 9 9 9 9 9 9 9 9 9 9 9 9 9 9 9 9 9 9 4 4 4
4 4 9 1 1 1 1 1 1 1 1 1 1 1 1 1 1 1 1 1 1 1 1 1 1 1 1 1 1 1 1 1 1 1 1 1 9 4 4 4
4 4 9 1 1 1 1 1 1 1 1 1 1 1 1 1 1 1 1 1 1 1 1 1 1 1 1 1 1 1 1 1 1 1 1 1 9 4 4 4
4 4 9 1 1 1 1 1 1 1 1 1 1 1 1 1 1 1 1 1 1 1 1 1 1 1 1 1 1 1 1 1 1 1 1 1 9 4 4 4
4 4 9 1 1 1 9 9 9 9 9 9 9 9 9 9 9 9 1 1 1 9 9 9 9 9 9 9 9 9 9 9 9 1 1 1 9 4 4 4
4 4 9 1 1 1 9 4 4 4 4 4 4 4 4 4 4 9 1 1 1 9 4 4 4 4 4 4 4 4 4 4 9 1 1 1 9 4 4 4
4 4 9 1 1 1 9 4 4 4 4 4 4 4 4 4 4 9 1 1 1 9 4 4 4 4 4 4 4 4 4 4 9 1 1 1 9 4 4 4
4 4 9 1 1 1 9 4 4 4 4 4 4 4 4 4 4 9 1 1 1 9 4 4 4 4 4 4 4 4 4 4 9 1 1 1 9 4 4 4
4 4 9 1 1 1 9 4 4 4 2 2 2 2 2 2 2 2 1 1 1 2 2 2 2 2 2 2 2 4 4 4 9 1 1 1 9 4 4 4
4 4 9 1 1 1 9 4 4 4 2 1 1 1 1 1 1 1 1 1 1 1 1 1 1 1 1 1 2 4 4 4 9 1 1 1 9 4 4 4
4 4 9 1 1 1 9 4 4 4 2 1 1 1 1 1 1 1 1 1 1 1 1 1 1 1 1 1 2 4 4 4 9 1 1 1 9 4 4 4
4 4 9 1 1 1 9 4 4 4 2 1 1 6 6 6 6 6 6 6 6 6 6 6 6 6 1 1 2 4 4 4 9 1 1 1 9 4 4 4
4 4 9 1 1 1 9 4 4 4 2 1 1 6 5 5 5 5 5 5 5 5 5 5 5 6 1 1 2 4 4 4 9 1 1 1 9 4 4 4
4 4 9 1 1 1 9 4 4 4 2 1 1 6 5 5 5 5 5 5 5 5 5 5 5 6 1 1 2 4 4 4 9 1 1 1 9 4 4 4
4 4 9 1 1 1 9 4 4 4 2 1 1 6 5 5 5 5 5 5 5 5 5 5 5 6 1 1 2 4 4 4 9 1 1 1 9 4 4 4
4 4 9 1 1 1 9 9 9 9 2 1 1 6 5 5 5 6 6 6 6 6 5 5 5 6 1 1 2 9 9 9 9 1 1 1 9 4 4 4
4 4 9 1 1 1 1 1 1 1 1 1 1 6 5 5 5 6 5 5 5 6 5 5 5 6 1 1 1 1 1 1 1 1 1 1 9 4 4 4
4 4 9 1 1 1 1 1 1 1 1 1 1 6 5 5 5 6 5 5 5 6 5 5 5 6 1 1 1 1 1 1 1 1 1 1 9 4 4 4
4 4 9 1 1 1 1 1 1 1 1 1 1 6 5 5 5 6 5 5 5 6 5 5 5 6 1 1 1 1 1 1 1 1 1 1 9 4 4 4
4 4 9 1 1 1 9 9 9 9 2 1 1 6 5 5 5 6 6 6 6 6 5 5 5 6 1 1 2 9 9 9 9 1 1 1 9 4 4 4
4 4 9 1 1 1 9 4 4 4 2 1 1 6 5 5 5 5 5 5 5 5 5 5 5 6 1 1 2 4 4 4 9 1 1 1 9 4 4 4
4 4 9 1 1 1 9 4 4 4 2 1 1 6 5 5 5 5 5 5 5 5 5 5 5 6 1 1 2 4 4 4 9 1 1 1 9 4 4 4
4 4 9 1 1 1 9 4 4 4 2 1 1 6 5 5 5 5 5 5 5 5 5 5 5 6 1 1 2 4 4 4 9 1 1 1 9 4 4 4
4 4 9 1 1 1 9 4 4 4 2 1 1 6 6 6 6 6 6 6 6 6 6 6 6 6 1 1 2 4 4 4 9 1 1 1 9 4 4 4
4 4 9 1 1 1 9 4 4 4 2 1 1 1 1 1 1 1 1 1 1 1 1 1 1 1 1 1 2 4 4 4 9 1 1 1 9 4 4 4
4 4 9 1 1 1 9 4 4 4 2 1 1 1 1 1 1 1 1 1 1 1 1 1 1 1 1 1 2 4 4 4 9 1 1 1 9 4 4 4
4 4 9 1 1 1 9 4 4 4 2 2 2 2 2 2 2 2 1 1 1 2 2 2 2 2 2 2 2 4 4 4 9 1 1 1 9 4 4 4
4 4 9 1 1 1 9 4 4 4 4 4 4 4 4 4 4 9 1 1 1 9 4 4 4 4 4 4 4 4 4 4 9 1 1 1 9 4 4 4
4 4 9 1 1 1 9 4 4 4 4 4 4 4 4 4 4 9 1 1 1 9 4 4 4 4 4 4 4 4 4 4 9 1 1 1 9 4 4 4
4 4 9 1 1 1 9 4 4 4 4 4 4 4 4 4 4 9 1 1 1 9 4 4 4 4 4 4 4 4 4 4 9 1 1 1 9 4 4 4
4 4 9 1 1 1 9 9 9 9 9 9 9 9 9 9 9 9 1 1 1 9 9 9 9 9 9 9 9 9 9 9 9 1 1 1 9 4 4 4
4 4 9 1 1 1 1 1 1 1 1 1 1 1 1 1 1 1 1 1 1 1 1 1 1 1 1 1 1 1 1 1 1 1 1 1 9 4 4 4
4 4 9 1 1 1 1 1 1 1 1 1 1 1 1 1 1 1 1 1 1 1 1 1 1 1 1 1 1 1 1 1 1 1 1 1 9 4 4 4
4 4 9 1 1 1 1 1 1 1 1 1 1 1 1 1 1 1 1 1 1 1 1 1 1 1 1 1 1 1 1 1 1 1 1 1 9 4 4 4
4 4 9 9 9 9 9 9 9 9 9 9 9 9 9 9 9 9 9 9 9 9 9 9 9 9 9 9 9 9 9 9 9 9 9 9 9 4 4 4
4 4 4 4 4 4 4 4 4 4 4 4 4 4 4 4 4 4 4 4 4 4 4 4 4 4 4 4 4 4 4 4 4 4 4 4 4 4 4 4
4 4 4 4 4 4 4 4 4 4 4 4 4 4 4 4 4 4 4 4 4 4 4 4 4 4 4 4 4 4 4 4 4 4 4 4 4 4 4 4


map.tile_heights:
158     158     158     158     158     158     158     158     158     158     158     158     158     158     158     158     158     158     158     158     158     158     158     158     158     158     158     158     158     158     158     158     158     158     158     158     158     158     158     158
158     0       0       0       0       0       0       0       0       0       0       0       0       0       0       0       0       0       0       0       0       0       0       0       0       0       0       0       0       0       0       0       0       0       0       0       0       0       0       158
158     0       0       0       0       0       0       0       0       0       0       0       0       0       0       0       0       0       0       0       0       0       0       0       0       0       0       0       0       0       0       0       0       0       0       0       0       0       0       158
158     0       5       5       5       5       5       5       5       5       5       5       5       5       5       5       5       5       5       5       5       5       5       5       5       5       5       5       5       5       5       5       5       5       5       5       5       0       0       158
158     0       5       0       0       0       0       0       0       0       0       0       0       0       0       0       0       0       0       0       0       0       0       0       0       0       0       0       0       0       0       0       0       0       0       0       5       0       0       158
158     0       5       0       0       0       0       0       0       0       0       0       0       0       0       0       0       0       0       0       0       0       0       0       0       0       0       0       0       0       0       0       0       0       0       0       5       0       0       158
158     0       5       0       0       0       0       0       0       0       0       0       0       0       0       0       0       0       0       0       0       0       0       0       0       0       0       0       0       0       0       0       0       0       0       0       5       0       0       158
158     0       5       0       0       0       5       5       5       5       5       5       5       5       5       5       5       5       0       0       0       5       5       5       5       5       5       5       5       5       5       5       5       0       0       0       5       0       0       158
158     0       5       0       0       0       5       0       0       0       0       0       0       0       0       0       0       5       0       0       0       5       0       0       0       0       0       0       0       0       0       0       5       0       0       0       5       0       0       158
158     0       5       0       0       0       5       0       0       0       0       0       0       0       0       0       0       5      10      10      10       5       0       0       0       0       0       0       0       0       0       0       5       0       0       0       5       0       0       158
158     0       5       0       0       0       5       0       0       0       0       0       0       0       0       0       0       5      20      20      20       5       0       0       0       0       0       0       0       0       0       0       5       0       0       0       5       0       0       158
158     0       5       0       0       0       5       0       0       0      55      55      55      55      55      55      55      55      30      30      30       55       55       55       55      55       55       55       55       0       0       0       5       0       0       0       5       0       0       158
158     0       5       0       0       0       5       0       0       0      55      40      40      40      40      40      40      40      40      40      40      40      40      40      40       40       40      40     55       0       0       0       5       0       0       0       5       0     0     158
158     0       5       0       0       0       5       0       0       0      55      40      40      40      40      40      40      40      40      40      40      40      40      40      40       40       40      40     55       0       0       0       5       0       0       0       5       0     0      158
158     0       5       0       0       0       5       0       0       0      55      40      40      60      60      60      60      60      60      60      60      60      60      60      60      60      40      40      55       0       0       0       5       0       0       0       5       0       0       158
158     0       5       0       0       0       5       0       0       0      55      40      40      60      55      55      55      55      55      55      55      55      55      55      55      60      40      40      55       0       0       0       5       0       0       0       5       0       0       158
158     0       5       0       0       0       5       0       0       0      55      40      40      60      55      100      55      55      55      55      55      55      55      100      55      60      40      40    55       0       0       0       5       0       0       0       5       0       0       158
158     0       5       0       0       0       5       0       0       0      55      40      40      60      55      55      55      55      55      55      55      55      55      55      55      60      40      40      55       0       0       0       5       0       0       0       5       0       0       158
158     0       5       0       0       0       5       5       5       5      55      40      40      60      55      55      55      60      60      60      60      60      55      55      55      60      40      40      55       5       5       5       5       0       0       0       5       0       0       158
158     0       5       0       0       0       0       0       10       20       30      40      40      60      55      55      55      60      55      55      55      60      55      55      55      60      40      40      30      20      10       0       0       0       0       0       5       0       0       158
158     0       5       0       0       0       0       0       10       20       30      40      40      60      55      55      55      60      55      120     55      60      55      55      55      60      40      40      30      20      10       0       0       0       0       0       5       0       0       158
158     0       5       0       0       0       0       0       10       20       30      40      40      60      55      55      55      60      55      55      55      60      55      55      55      60      40      40      30      20      10       0       0       0       0       0       5       0       0       158
158     0       5       0       0       0       5       5       5       5       55      40      40      60      55      55      55      60      60      60      60      60      55      55      55      60      40      40      55       5       5       5       5       0       0       0       5       0       0       158
158     0       5       0       0       0       5       0       0       0       55      40      40      60      55      55      55      55      55      55      55      55      55      55      55      60      40      40      55       0       0       0       5       0       0       0       5       0       0       158
158     0       5       0       0       0       5       0       0       0       55      40      40      60      55      100      55      55      55      55      55      55      55      100      55      60      40      40    55       0       0       0       5       0       0       0       5       0       0       158
158     0       5       0       0       0       5       0       0       0       55      40      40      60      55      55      55      55      55      55      55      55      55      55      55      60      40      40     55       0       0       0       5       0       0       0       5       0       0       158
158     0       5       0       0       0       5       0       0       0       55      40      40      60      60      60      60      60      60      60      60      60      60      60      60      60      40      40     55       0       0       0       5       0       0       0       5       0       0       158
158     0       5       0       0       0       5       0       0       0       55      40      40      40      40      40      40      40      40      40      40      40      40      40      40      40      40      40     55       0       0       0       5       0       0       0       5       0       0       158
158     0       5       0       0       0       5       0       0       0       55      40      40      40      40      40      40      40      40      40      40      40      40      40      40      40      40      40     55       0       0       0       5       0       0       0       5       0       0       158
158     0       5       0       0       0       5       0       0       0       55      55      55      55      55      55      55      55      30      30      30      55      55      55      55      55      55      55      55       0       0       0       5       0       0       0       5       0       0       158
158     0       5       0       0       0       5       0       0       0       0       0       0       0       0       0       0       5      20      20       20       5       0       0       0       0       0       0       0       0       0       0       5       0       0       0       5       0       0       158
158     0       5       0       0       0       5       0       0       0       0       0       0       0       0       0       0       5      10      10       10       5       0       0       0       0       0       0       0       0       0       0       5       0       0       0       5       0       0       158
158     0       5       0       0       0       5       0       0       0       0       0       0       0       0       0       0       5       0       0       0       5       0       0       0       0       0       0       0       0       0       0       5       0       0       0       5       0       0       158
158     0       5       0       0       0       5       5       5       5       5       5       5       5       5       5       5       5       0       0       0       5       5       5       5       5       5       5       5       5       5       5       5       0       0       0       5       0       0       158
158     0       5       0       0       0       0       0       0       0       0       0       0       0       0       0       0       0       0       0       0       0       0       0       0       0       0       0       0       0       0       0       0       0       0       0       5       0       0       158
158     0       5       0       0       0       0       0       0       0       0       0       0       0       0       0       0       0       0       0       0       0       0       0       0       0       0       0       0       0       0       0       0       0       0       0       5       0       0       158
158     0       5       0       0       0       0       0       0       0       0       0       0       0       0       0       0       0       0       0       0       0       0       0       0       0       0       0       0       0       0       0       0       0       0       0       5       0       0       158
158     0       5       5       5       5       5       5       5       5       5       5       5       5       5       5       5       5       5       5       5       5       5       5       5       5       5       5       5       5       5       5       5       5       5       5       5       0       0       158
158     0       0       0       0       0       0       0       0       0       0       0       0       0       0       0       0       0       0       0       0       0       0       0       0       0       0       0       0       0       0       0       0       0       0       0       0       0       0       158
158     158     158     158     158     158     158     158     158     158     158     158     158     158     158     158     158     158     158     158     158     158     158     158     158     158     158     158     158     158     158     158     158     158     158     158     158     158     158     158
z

